[
  {
    "grid": [
      ["💎","⚪","💎","⚪","💎"],
      ["⚪","💎","⚪","💎","⚪"],
      ["💎","⚪","💎","⚪","💎"],
      ["⚪","💎","⚪","💎","⚪"],
      ["💎","⚪","💎","⚪","💎"]
    ],
    "goal": [
      ["⚪","⚪","⚪","⚪","⚪"],
      ["⚪","⚪","⚪","⚪","⚪"],
      ["⚪","⚪","⚪","⚪","⚪"],
      ["⚪","⚪","⚪","⚪","⚪"],
      ["⚪","⚪","⚪","⚪","⚪"]
    ]
  },
  {
    "grid": [
      ["⚪","💎","⚪","💎","⚪"],
      ["💎","⚪","💎","⚪","💎"],
      ["⚪","💎","⚪","💎","⚪"],
      ["💎","⚪","💎","⚪","💎"],
      ["⚪","💎","⚪","💎","⚪"]
    ],
    "goal": [
      ["💎","💎","💎","💎","💎"],
      ["💎","💎","💎","💎","💎"],
      ["💎","💎","💎","💎","💎"],
      ["💎","💎","💎","💎","💎"],
      ["💎","💎","💎","💎","💎"]
    ]
  },
  {
    "grid": [
      ["⚪","⚪","💎","⚪","⚪"],
      ["⚪","💎","⚪","💎","⚪"],
      ["💎","⚪","⚪","⚪","💎"],
      ["⚪","💎","⚪","💎","⚪"],
      ["⚪","⚪","💎","⚪","⚪"]
    ],
    "goal": [
      ["💎","💎","💎","💎","💎"],
      ["💎","💎","💎","💎","💎"],
      ["💎","💎","💎","💎","💎"],
      ["💎","💎","💎","💎","💎"],
      ["💎","💎","💎","💎","💎"]
    ]
  }
]
